//MAP CONVERTED BY dmm2tgm.py THIS HEADER COMMENT PREVENTS RECONVERSION, DO NOT REMOVE
"aD" = (
/obj/structure/fence/cut/medium,
/turf/open/misc/asteroid/snow/icemoon,
/area/icemoon/underground/explored)
"aU" = (
/turf/open/genturf,
/area/icemoon/underground/unexplored/rivers)
"cv" = (
/obj/structure/flora/rock/pile/icy/style_random,
/obj/machinery/light/small/directional/north,
/turf/open/misc/asteroid/snow/icemoon,
/area/ruin/space/has_grav/listeningstation)
"cH" = (
/obj/structure/table/reinforced/rglass,
/obj/item/radio/intercom,
/turf/open/floor/iron/dark,
/area/ruin/space/has_grav/listeningstation)
"cO" = (
/turf/open/floor/plating/snowed/smoothed/icemoon,
/area/icemoon/underground/unexplored/rivers)
"dq" = (
/obj/structure/flora/tree/dead/style_random,
/obj/structure/flora/grass/green/style_random,
/turf/open/misc/asteroid/snow/icemoon,
/area/icemoon/underground/explored)
"el" = (
/obj/structure/flora/grass/green/style_random,
/turf/open/misc/asteroid/snow/icemoon,
/area/icemoon/underground/explored)
"eC" = (
/obj/effect/turf_decal/stripes/line{
	dir = 1
	},
/obj/machinery/door/airlock/external/glass/ruin,
/turf/open/floor/iron/smooth{
	initial_gas_mix = "ICEMOON_ATMOS"
	},
/area/ruin/space/has_grav/listeningstation)
"gH" = (
/obj/structure/fence/end{
	dir = 4
	},
/turf/open/floor/plating/snowed/smoothed/icemoon,
/area/icemoon/underground/explored)
"hY" = (
/turf/open/misc/asteroid/snow/icemoon,
/area/icemoon/underground/unexplored/rivers)
"kr" = (
/turf/open/floor/iron/smooth{
	initial_gas_mix = "ICEMOON_ATMOS"
	},
/area/ruin/space/has_grav/listeningstation)
"oj" = (
/obj/effect/decal/cleanable/dirt,
/obj/structure/bed,
/obj/item/bedsheet/dorms,
/obj/effect/mob_spawn/ghost_role/human/snow_operative,
/turf/open/floor/iron/grimy{
	initial_gas_mix = "ICEMOON_ATMOS"
	},
/area/ruin/space/has_grav/listeningstation)
"oD" = (
/turf/open/floor/iron/dark,
/area/ruin/space/has_grav/listeningstation)
"qS" = (
/turf/open/misc/asteroid/snow/icemoon,
/area/icemoon/underground/explored)
"rd" = (
/obj/structure/table/reinforced/rglass,
/obj/item/paper_bin{
	pixel_x = -3;
	pixel_y = 7
	},
/turf/open/floor/iron/dark,
/area/ruin/space/has_grav/listeningstation)
"rm" = (
/obj/structure/table/reinforced/rglass,
/turf/open/floor/iron/dark,
/area/ruin/space/has_grav/listeningstation)
"rS" = (
/obj/structure/flora/tree/pine/style_random,
/obj/structure/flora/grass/green/style_random,
/turf/open/misc/asteroid/snow/icemoon,
/area/icemoon/underground/explored)
"st" = (
/obj/machinery/door/airlock/public,
/turf/open/floor/iron/dark,
/area/ruin/space/has_grav/listeningstation)
"te" = (
/turf/open/floor/plating,
/area/ruin/space/has_grav/listeningstation)
"th" = (
/obj/structure/fence/end{
	dir = 8
	},
/turf/open/misc/asteroid/snow/icemoon,
/area/icemoon/underground/explored)
"uz" = (
/obj/structure/tank_dispenser/oxygen,
/turf/open/floor/iron/smooth{
	initial_gas_mix = "ICEMOON_ATMOS"
	},
/area/ruin/space/has_grav/listeningstation)
"vh" = (
/obj/item/chair/plastic,
/turf/open/floor/iron/dark,
/area/ruin/space/has_grav/listeningstation)
"wg" = (
/obj/effect/turf_decal/box/corners{
	dir = 4
	},
/turf/open/floor/plating,
/area/ruin/space/has_grav/listeningstation)
"wJ" = (
/obj/structure/sink/directional/south,
/turf/open/floor/iron/dark,
/area/ruin/space/has_grav/listeningstation)
"wP" = (
/turf/open/floor/plating/snowed/smoothed/icemoon,
/area/icemoon/underground/explored)
"yl" = (
/obj/structure/flora/tree/pine/style_random,
/turf/open/misc/asteroid/snow/icemoon,
/area/icemoon/underground/explored)
"yW" = (
/obj/effect/turf_decal/stripes/line{
	dir = 8
	},
/obj/structure/rack,
/obj/item/stack/cable_coil/five,
/obj/item/wirecutters,
/turf/open/floor/plating,
/area/ruin/space/has_grav/listeningstation)
"zi" = (
/obj/machinery/suit_storage_unit/syndicate,
/turf/open/floor/iron/smooth{
	initial_gas_mix = "ICEMOON_ATMOS"
	},
/area/ruin/space/has_grav/listeningstation)
"zk" = (
/obj/effect/turf_decal/stripes/line{
	dir = 4
	},
/obj/structure/tank_holder/extinguisher{
	pixel_x = -3;
	pixel_y = 7
	},
/turf/open/floor/plating,
/area/ruin/space/has_grav/listeningstation)
"zz" = (
/obj/effect/turf_decal/stripes/line{
	dir = 4
	},
/obj/structure/reagent_dispensers/fueltank,
/turf/open/floor/plating,
/area/ruin/space/has_grav/listeningstation)
"AY" = (
/obj/structure/fence/corner{
	dir = 6
	},
/turf/open/floor/plating/snowed/smoothed/icemoon,
/area/icemoon/underground/explored)
"Cr" = (
/obj/structure/table/reinforced/rglass,
/obj/item/pen/red{
	pixel_x = -17;
	pixel_y = 4
	},
/obj/item/toy/crayon/spraycan,
/obj/machinery/light/small/directional/north,
/turf/open/floor/iron/dark,
/area/ruin/space/has_grav/listeningstation)
"Cu" = (
/obj/structure/fence/cut/large,
/turf/open/misc/asteroid/snow/icemoon,
/area/icemoon/underground/explored)
"Et" = (
/obj/effect/turf_decal/stripes/line{
	dir = 4
	},
/obj/machinery/light/small/directional/south,
/obj/machinery/button/door/directional/north{
	id = "ice_comms_car";
	name = "Garage Door Button";
	pixel_x = -23;
	pixel_y = 22;
	req_access = list("research")
	},
/turf/open/floor/plating,
/area/ruin/space/has_grav/listeningstation)
"FK" = (
/obj/machinery/light/small/broken/directional/north,
/turf/open/floor/plating/snowed/smoothed/icemoon,
/area/ruin/space/has_grav/listeningstation)
"Gl" = (
/obj/effect/decal/cleanable/dirt,
/obj/structure/dresser,
/obj/machinery/light/small/broken/directional/west,
/turf/open/floor/iron/grimy{
	initial_gas_mix = "ICEMOON_ATMOS"
	},
/area/ruin/space/has_grav/listeningstation)
"HT" = (
/obj/structure/closet/wardrobe/grey,
/obj/effect/spawner/random/maintenance/three,
/turf/open/floor/iron/dark,
/area/ruin/space/has_grav/listeningstation)
"Jh" = (
/obj/structure/fence,
/turf/open/floor/plating/snowed/smoothed/icemoon,
/area/icemoon/underground/explored)
"Js" = (
/obj/structure/fence,
/turf/open/misc/asteroid/snow/icemoon,
/area/icemoon/underground/explored)
"Jt" = (
/turf/closed/wall/ice,
/area/ruin/space/has_grav/listeningstation)
"Kh" = (
/obj/effect/turf_decal/stripes/line{
	dir = 8
	},
/obj/structure/rack,
/obj/item/wrench,
/obj/item/crowbar/large/heavy,
/obj/machinery/light/small/built/directional/south,
/turf/open/floor/plating,
/area/ruin/space/has_grav/listeningstation)
"Ly" = (
/obj/structure/fence/end{
	dir = 1
	},
/turf/open/misc/asteroid/snow/icemoon,
/area/icemoon/underground/explored)
"MS" = (
/obj/effect/turf_decal/siding/wood{
	dir = 1
	},
/obj/effect/turf_decal/siding/wood,
/obj/machinery/door/airlock/shuttle,
/turf/open/floor/iron/grimy{
	initial_gas_mix = "ICEMOON_ATMOS"
	},
/area/ruin/space/has_grav/listeningstation)
"NO" = (
/obj/effect/decal/cleanable/dirt,
/turf/open/floor/iron/grimy{
	initial_gas_mix = "ICEMOON_ATMOS"
	},
/area/ruin/space/has_grav/listeningstation)
"Oi" = (
/obj/effect/turf_decal/box/corners{
	dir = 1
	},
/turf/open/floor/plating,
/area/ruin/space/has_grav/listeningstation)
"OM" = (
/obj/effect/turf_decal/stripes/line{
	dir = 8
	},
/obj/structure/rack,
/turf/open/floor/plating,
/area/ruin/space/has_grav/listeningstation)
"Qj" = (
/obj/effect/turf_decal/box/corners,
/obj/item/plate/oven_tray{
	color = "#858585";
	desc = "A convenient place to put all your loose ends!";
	name = "Mechanic's Tray";
	pixel_x = 1;
	pixel_y = 2
	},
/obj/item/screwdriver,
/turf/open/floor/plating,
/area/ruin/space/has_grav/listeningstation)
"RK" = (
/obj/effect/turf_decal/stripes/line,
/obj/effect/turf_decal/stripes/line{
	dir = 1
	},
/obj/machinery/door/poddoor/shutters{
	id = "ice_comms_car"
	},
/turf/open/floor/plating,
/area/ruin/space/has_grav/listeningstation)
"SK" = (
/obj/effect/turf_decal/stripes/line,
/obj/machinery/door/airlock/external/ruin,
/turf/open/floor/iron/smooth{
	initial_gas_mix = "ICEMOON_ATMOS"
	},
/area/ruin/space/has_grav/listeningstation)
"SR" = (
/obj/machinery/light/small/directional/north,
/turf/open/floor/plating/snowed/smoothed/icemoon,
/area/ruin/space/has_grav/listeningstation)
"Tz" = (
/obj/structure/flora/tree/dead/style_random,
/turf/open/misc/asteroid/snow/icemoon,
/area/icemoon/underground/explored)
"TG" = (
/obj/structure/flora/rock/pile/icy/style_random,
/turf/open/misc/asteroid/snow/icemoon,
/area/icemoon/underground/explored)
"Vq" = (
/obj/effect/turf_decal/box/corners{
	dir = 8
	},
/turf/open/floor/plating,
/area/ruin/space/has_grav/listeningstation)
"VN" = (
/obj/structure/frame/computer{
	dir = 1
	},
/obj/machinery/light/small/directional/south,
/turf/open/floor/iron/dark,
/area/ruin/space/has_grav/listeningstation)

(1,1,1) = {"
aU
aU
aU
aU
aU
aU
aU
aU
aU
TG
qS
Tz
aU
aU
aU
aU
aU
"}
(2,1,1) = {"
aU
aU
aU
aU
aU
aU
aU
qS
Tz
qS
qS
qS
el
qS
aU
aU
aU
"}
(3,1,1) = {"
aU
aU
aU
aU
qS
qS
qS
qS
qS
el
qS
qS
qS
qS
aU
aU
aU
"}
(4,1,1) = {"
aU
aU
aU
qS
TG
Jt
Jt
Jt
Jt
Jt
Jt
yl
TG
aU
aU
aU
aU
"}
(5,1,1) = {"
aU
aU
qS
Jt
Jt
Jt
rd
cH
cH
rm
Jt
Jt
Jt
Cu
Ly
aU
aU
"}
(6,1,1) = {"
aU
qS
TG
Jt
Gl
Jt
Cr
oD
vh
VN
Jt
uz
Jt
FK
wP
qS
aU
"}
(7,1,1) = {"
aU
qS
qS
Jt
NO
MS
oD
oD
oD
oD
eC
kr
SK
wP
qS
wP
qS
"}
(8,1,1) = {"
aU
qS
qS
Jt
oj
Jt
wJ
HT
oD
oD
Jt
zi
Jt
cv
wP
aU
aU
"}
(9,1,1) = {"
aU
TG
el
Jt
Jt
Jt
st
Jt
Jt
Jt
Jt
Jt
Jt
Js
Ly
aU
aU
"}
(10,1,1) = {"
aU
dq
Jt
Jt
zz
zk
Et
Jt
SR
wP
wP
qS
th
yl
aU
aU
aU
"}
(11,1,1) = {"
aU
aU
Jt
Oi
te
Vq
te
RK
wP
wP
el
wP
qS
hY
cO
aU
aU
"}
(12,1,1) = {"
aU
aU
Jt
wg
te
Qj
te
RK
wP
qS
wP
wP
wP
hY
hY
cO
aU
"}
(13,1,1) = {"
aU
aU
Jt
Jt
OM
yW
Kh
Jt
FK
wP
qS
wP
gH
aU
aU
aU
aU
"}
(14,1,1) = {"
aU
aU
aU
Jt
Jt
Jt
Jt
Jt
aD
Jh
Jh
Cu
AY
aU
aU
aU
aU
"}
(15,1,1) = {"
aU
aU
aU
aU
aU
el
rS
aU
aU
aU
aU
aU
aU
aU
aU
aU
aU
"}
