//MAP CONVERTED BY dmm2tgm.py THIS HEADER COMMENT PREVENTS RECONVERSION, DO NOT REMOVE
"aD" = (
/turf/open/floor/pod/dark,
/area/ruin/space/has_grav/listeningstation)
"aU" = (
/turf/template_noop,
/area/template_noop)
"bi" = (
/obj/structure/cable,
/obj/item/storage/toolbox/syndicate,
/obj/structure/closet/syndicate/personal,
/obj/item/gun/ballistic/automatic/pistol/clandestine,
/obj/item/ammo_box/magazine/m10mm,
/obj/item/ammo_box/magazine/m10mm,
/obj/item/clothing/mask/chameleon/gps,
/turf/open/floor/pod/dark,
/area/ruin/space/has_grav/listeningstation)
"cv" = (
/obj/structure/flora/rock/pile/icy/style_random,
/obj/machinery/light/small/directional/north,
/turf/open/misc/asteroid/snow/icemoon,
/area/ruin/space/has_grav/listeningstation)
"cH" = (
/obj/structure/table/reinforced/rglass,
/obj/item/radio/intercom,
/turf/open/floor/pod/dark,
/area/ruin/space/has_grav/listeningstation)
"cO" = (
/turf/open/floor/plating/snowed/smoothed/icemoon,
/area/template_noop)
"dq" = (
/obj/structure/flora/tree/dead/style_random,
/obj/structure/flora/grass/green/style_random,
/turf/open/misc/asteroid/snow/icemoon,
/area/icemoon/underground/explored)
"el" = (
/obj/structure/flora/grass/green/style_random,
/turf/open/misc/asteroid/snow/icemoon,
/area/icemoon/underground/explored)
"eC" = (
/obj/effect/turf_decal/stripes/line{
	dir = 1
	},
/obj/machinery/door/airlock/external/ruin,
/obj/effect/mapping_helpers/airlock/access/all/syndicate/general,
/turf/open/floor/iron/smooth{
	initial_gas_mix = "ICEMOON_ATMOS"
	},
/area/ruin/space/has_grav/listeningstation)
"gi" = (
/obj/machinery/light/small/directional/east,
/obj/effect/turf_decal/stripes/line{
	dir = 8
	},
/obj/machinery/telecomms/server/presets/common/birdstation,
/turf/open/floor/pod/dark,
/area/ruin/space/has_grav/listeningstation)
"gH" = (
/obj/structure/fence/end{
	dir = 4
	},
/turf/open/floor/plating/snowed/smoothed/icemoon,
/area/icemoon/underground/explored)
"hY" = (
/turf/open/misc/asteroid/snow/icemoon,
/area/template_noop)
"iT" = (
/obj/structure/cable,
/turf/open/floor/plating,
/area/ruin/space/has_grav/listeningstation)
"kr" = (
/turf/open/floor/iron/smooth{
	initial_gas_mix = "ICEMOON_ATMOS"
	},
/area/ruin/space/has_grav/listeningstation)
"oj" = (
/obj/effect/decal/cleanable/dirt,
/obj/structure/bed,
/obj/item/bedsheet/dorms,
/obj/effect/mob_spawn/ghost_role/human/snow_operative,
/turf/open/floor/iron/grimy{
	initial_gas_mix = "ICEMOON_ATMOS"
	},
/area/ruin/space/has_grav/listeningstation)
"ow" = (
/obj/machinery/light/small/directional/south,
/obj/effect/turf_decal/stripes/line{
	dir = 4
	},
/obj/machinery/telecomms/processor/preset_one/birdstation{
	name = "processor unit"
	},
/turf/open/floor/pod/dark,
/area/ruin/space/has_grav/listeningstation)
"oD" = (
/obj/structure/cable,
/turf/open/floor/pod/dark,
/area/ruin/space/has_grav/listeningstation)
"qS" = (
/turf/open/misc/asteroid/snow/icemoon,
/area/icemoon/underground/explored)
"rd" = (
/obj/structure/table/reinforced/rglass,
/obj/item/paper_bin{
	pixel_x = -3;
	pixel_y = 7
	},
/turf/open/floor/pod/dark,
/area/ruin/space/has_grav/listeningstation)
"rm" = (
/obj/machinery/computer/communications/syndicate{
	dir = 4
	},
/turf/open/floor/pod/dark,
/area/ruin/space/has_grav/listeningstation)
"rS" = (
/obj/structure/flora/tree/pine/style_random,
/obj/structure/flora/grass/green/style_random,
/turf/open/misc/asteroid/snow/icemoon,
/area/icemoon/underground/explored)
"st" = (
/obj/machinery/door/airlock/public,
/obj/structure/cable,
/turf/open/floor/pod/dark,
/area/ruin/space/has_grav/listeningstation)
"te" = (
/turf/open/floor/plating,
/area/ruin/space/has_grav/listeningstation)
"th" = (
/obj/structure/fence/end{
	dir = 8
	},
/turf/open/misc/asteroid/snow/icemoon,
/area/icemoon/underground/explored)
"uz" = (
/obj/structure/tank_dispenser/oxygen,
/turf/open/floor/iron/smooth{
	initial_gas_mix = "ICEMOON_ATMOS"
	},
/area/ruin/space/has_grav/listeningstation)
"vh" = (
/obj/structure/chair/comfy/shuttle/tactical{
	dir = 8
	},
/turf/open/floor/pod/dark,
/area/ruin/space/has_grav/listeningstation)
"wg" = (
/obj/effect/turf_decal/box/corners{
	dir = 4
	},
/obj/item/gps/computer{
	gpstag = "SYND01"
	},
/turf/open/floor/plating,
/area/ruin/space/has_grav/listeningstation)
"wJ" = (
/obj/structure/sink/directional/south,
/obj/structure/cable,
/turf/open/floor/pod/dark,
/area/ruin/space/has_grav/listeningstation)
"wP" = (
/turf/open/floor/plating/snowed/smoothed/icemoon,
/area/icemoon/underground/explored)
"yl" = (
/obj/structure/flora/tree/pine/style_random,
/turf/open/misc/asteroid/snow/icemoon,
/area/icemoon/underground/explored)
"yW" = (
/obj/effect/turf_decal/stripes/line{
	dir = 8
	},
/obj/structure/rack,
/obj/item/stack/cable_coil/five,
/obj/item/wirecutters,
/obj/item/crowbar/large/heavy,
/obj/item/wrench,
/obj/item/key/atv,
/turf/open/floor/pod/dark,
/area/ruin/space/has_grav/listeningstation)
"zi" = (
/obj/machinery/suit_storage_unit/syndicate,
/turf/open/floor/iron/smooth{
	initial_gas_mix = "ICEMOON_ATMOS"
	},
/area/ruin/space/has_grav/listeningstation)
"zk" = (
/obj/effect/turf_decal/stripes/line{
	dir = 4
	},
/obj/structure/cable,
/obj/machinery/power/smes/engineering,
/turf/open/floor/pod/dark,
/area/ruin/space/has_grav/listeningstation)
"zt" = (
/obj/structure/cable,
/turf/closed/wall/mineral/titanium/survival/nodiagonal,
/area/ruin/space/has_grav/listeningstation)
"zz" = (
/obj/effect/turf_decal/stripes/line{
	dir = 4
	},
/obj/structure/reagent_dispensers/fueltank,
/turf/open/floor/pod/dark,
/area/ruin/space/has_grav/listeningstation)
"AV" = (
/obj/structure/cable,
/obj/machinery/power/rtg/advanced,
/turf/open/floor/plating/snowed/smoothed/icemoon,
/area/icemoon/underground/explored)
"AY" = (
/obj/structure/fence/corner{
	dir = 6
	},
/turf/open/floor/plating/snowed/smoothed/icemoon,
/area/icemoon/underground/explored)
"Cr" = (
/obj/structure/table/reinforced/rglass,
/obj/item/pen/red{
	pixel_x = -17;
	pixel_y = 4
	},
/obj/item/toy/crayon/spraycan,
/obj/machinery/light/small/directional/north,
/turf/open/floor/pod/dark,
/area/ruin/space/has_grav/listeningstation)
"Cu" = (
/obj/structure/fence/cut/large,
/turf/open/misc/asteroid/snow/icemoon,
/area/icemoon/underground/explored)
"Et" = (
/obj/effect/turf_decal/stripes/line{
	dir = 4
	},
/obj/machinery/button/door/directional/north{
	id = "ice_comms_car";
	name = "Garage Door Button";
	pixel_x = -23;
	pixel_y = 22;
	req_access = list("research")
	},
/obj/structure/cable,
/obj/machinery/power/terminal{
	dir = 1
	},
/turf/open/floor/pod/dark,
/area/ruin/space/has_grav/listeningstation)
"FK" = (
/obj/machinery/light/small/broken/directional/north,
/turf/open/floor/plating/snowed/smoothed/icemoon,
/area/ruin/space/has_grav/listeningstation)
"Gl" = (
/obj/effect/decal/cleanable/dirt,
/obj/structure/dresser,
/obj/machinery/light/small/directional/west,
/turf/open/floor/iron/grimy{
	initial_gas_mix = "ICEMOON_ATMOS"
	},
/area/ruin/space/has_grav/listeningstation)
"HT" = (
/obj/effect/spawner/random/maintenance/three,
/obj/structure/cable,
/obj/structure/closet/syndicate,
/turf/open/floor/pod/dark,
/area/ruin/space/has_grav/listeningstation)
"Il" = (
/obj/vehicle/ridden/atv,
/turf/open/floor/plating,
/area/ruin/space/has_grav/listeningstation)
"Jh" = (
/turf/closed/wall/mineral/titanium/survival/nodiagonal,
/area/ruin/space/has_grav/listeningstation)
"Js" = (
/obj/structure/fence,
/turf/open/misc/asteroid/snow/icemoon,
/area/icemoon/underground/explored)
"Jt" = (
/obj/effect/turf_decal/stripes/line{
	dir = 8
	},
/obj/machinery/telecomms/receiver/preset_left/birdstation{
	name = "subspace receiver"
	},
/turf/open/floor/pod/dark,
/area/ruin/space/has_grav/listeningstation)
"Kh" = (
/obj/effect/turf_decal/stripes/line{
	dir = 8
	},
/obj/machinery/telecomms/broadcaster/preset_left/birdstation{
	name = "subspace broadcaster"
	},
/turf/open/floor/pod/dark,
/area/ruin/space/has_grav/listeningstation)
"Ly" = (
/obj/structure/fence/end{
	dir = 1
	},
/turf/open/misc/asteroid/snow/icemoon,
/area/icemoon/underground/explored)
"LZ" = (
/obj/machinery/power/port_gen/pacman/super,
/obj/structure/cable,
/obj/item/stack/sheet/mineral/uranium{
	amount = 25
	},
/turf/open/floor/pod/dark,
/area/ruin/space/has_grav/listeningstation)
"MS" = (
/obj/effect/turf_decal/siding/wood{
	dir = 1
	},
/obj/effect/turf_decal/siding/wood,
/obj/machinery/door/airlock/shuttle,
/obj/structure/cable,
/turf/open/floor/iron/grimy{
	initial_gas_mix = "ICEMOON_ATMOS"
	},
/area/ruin/space/has_grav/listeningstation)
"NO" = (
/obj/effect/decal/cleanable/dirt,
/obj/structure/cable,
/turf/open/floor/iron/grimy{
	initial_gas_mix = "ICEMOON_ATMOS"
	},
/area/ruin/space/has_grav/listeningstation)
"Oi" = (
/obj/effect/turf_decal/box/corners{
	dir = 1
	},
/obj/structure/cable,
/obj/machinery/power/apc/auto_name/directional/north,
/obj/effect/mapping_helpers/apc/cell_10k,
/obj/effect/mapping_helpers/apc/syndicate_access,
/obj/machinery/smartfridge/survival_pod/preloaded{
	name = "syndicate listening pod storage"
	},
/turf/open/floor/plating,
/area/ruin/space/has_grav/listeningstation)
"OM" = (
/obj/effect/turf_decal/stripes/line{
	dir = 8
	},
/obj/structure/tank_holder/extinguisher{
	pixel_x = -3;
	pixel_y = 7
	},
/turf/open/floor/pod/dark,
/area/ruin/space/has_grav/listeningstation)
"Pe" = (
/obj/machinery/light/small/directional/west,
/obj/effect/turf_decal/stripes/line{
	dir = 4
	},
/obj/machinery/telecomms/message_server/preset,
/turf/open/floor/pod/dark,
/area/ruin/space/has_grav/listeningstation)
"Pk" = (
/obj/machinery/light/small/directional/south,
/obj/effect/turf_decal/stripes/line{
	dir = 8
	},
/obj/machinery/telecomms/allinone/nuclear,
/turf/open/floor/pod/dark,
/area/ruin/space/has_grav/listeningstation)
"Qj" = (
/obj/item/screwdriver,
/turf/open/floor/plating,
/area/ruin/space/has_grav/listeningstation)
"QI" = (
/obj/effect/turf_decal/box/corners,
/turf/open/floor/plating,
/area/ruin/space/has_grav/listeningstation)
"RK" = (
/obj/effect/turf_decal/stripes/line,
/obj/effect/turf_decal/stripes/line{
	dir = 1
	},
/obj/machinery/door/poddoor/shutters{
	id = "ice_comms_car"
	},
/obj/structure/fans/tiny,
/turf/open/floor/plating,
/area/ruin/space/has_grav/listeningstation)
"SK" = (
/obj/effect/turf_decal/stripes/line,
/obj/machinery/door/airlock/external/ruin,
/obj/effect/mapping_helpers/airlock/access/all/syndicate/general,
/obj/structure/fans/tiny,
/turf/open/floor/iron/smooth{
	initial_gas_mix = "ICEMOON_ATMOS"
	},
/area/ruin/space/has_grav/listeningstation)
"SR" = (
/obj/effect/turf_decal/stripes/line{
	dir = 4
	},
/obj/machinery/telecomms/hub/preset,
/turf/open/floor/pod/dark,
/area/ruin/space/has_grav/listeningstation)
"Tz" = (
/obj/structure/flora/tree/dead/style_random,
/turf/open/misc/asteroid/snow/icemoon,
/area/icemoon/underground/explored)
"TG" = (
/obj/structure/flora/rock/pile/icy/style_random,
/turf/open/misc/asteroid/snow/icemoon,
/area/icemoon/underground/explored)
"Vq" = (
/obj/effect/turf_decal/box/corners{
	dir = 8
	},
/turf/open/floor/plating,
/area/ruin/space/has_grav/listeningstation)
"VN" = (
/obj/machinery/light/small/directional/south,
/turf/open/floor/pod/dark,
/area/ruin/space/has_grav/listeningstation)
"Yg" = (
/obj/machinery/light/small/directional/north,
/turf/open/floor/plating/snowed/smoothed/icemoon,
/area/icemoon/underground/explored)
"Zh" = (
/obj/machinery/light/small/broken/directional/north,
/turf/open/floor/plating/snowed/smoothed/icemoon,
/area/icemoon/underground/explored)

(1,1,1) = {"
aU
aU
aU
aU
aU
aU
aU
aU
aU
TG
qS
Tz
aU
aU
aU
aU
aU
"}
(2,1,1) = {"
aU
aU
aU
aU
aU
aU
aU
qS
Tz
qS
qS
qS
el
qS
aU
aU
aU
"}
(3,1,1) = {"
aU
aU
aU
aU
qS
qS
qS
qS
qS
el
qS
qS
qS
qS
aU
aU
aU
"}
(4,1,1) = {"
aU
aU
aU
qS
TG
Jh
Jh
Jh
Jh
Jh
Jh
yl
TG
aU
aU
aU
aU
"}
(5,1,1) = {"
aU
aU
qS
Jh
Jh
Jh
rd
cH
cH
rm
Jh
Jh
Jh
Cu
Ly
aU
aU
"}
(6,1,1) = {"
aU
qS
AV
Jh
Gl
Jh
Cr
aD
vh
VN
Jh
uz
Jh
FK
wP
qS
aU
"}
(7,1,1) = {"
aU
qS
AV
zt
NO
MS
oD
aD
aD
aD
eC
kr
SK
wP
qS
wP
qS
"}
(8,1,1) = {"
aU
qS
AV
Jh
oj
Jh
wJ
HT
bi
LZ
Jh
zi
Jh
cv
wP
aU
aU
"}
(9,1,1) = {"
aU
TG
el
Jh
Jh
Jh
st
Jh
Jh
Jh
Jh
Jh
Jh
Js
Ly
aU
aU
"}
(10,1,1) = {"
aU
dq
Jh
Jh
zz
zk
Et
Pe
SR
ow
Jh
Yg
th
yl
aU
aU
aU
"}
(11,1,1) = {"
aU
aU
Jh
Oi
iT
iT
te
te
te
Vq
RK
wP
qS
hY
cO
aU
aU
"}
(12,1,1) = {"
aU
aU
Jh
wg
te
Qj
te
te
Il
QI
RK
wP
wP
hY
hY
cO
aU
"}
(13,1,1) = {"
aU
aU
Jh
Jh
OM
yW
Kh
Jt
gi
Pk
Jh
Zh
gH
aU
aU
aU
aU
"}
(14,1,1) = {"
aU
aU
aU
Jh
Jh
Jh
Jh
Jh
Jh
Jh
Jh
Cu
AY
aU
aU
aU
aU
"}
(15,1,1) = {"
aU
aU
aU
aU
aU
el
rS
aU
aU
aU
aU
aU
aU
aU
aU
aU
aU
"}
