//MAP CONVERTED BY dmm2tgm.py THIS HEADER COMMENT PREVENTS RECONVERSION, DO NOT REMOVE
"a" = (
/turf/template_noop,
/area/template_noop)
"l" = (
/turf/open/floor/carpet/blue,
/area/template_noop)
"m" = (
/obj/effect/spawner/structure/window/reinforced/shuttle,
/turf/open/floor/plating,
/area/template_noop)
"p" = (
/obj/structure/showcase/machinery/tv{
	icon_state = "computer_broken";
	desc = "You can't navigate a broken-down husk anywhere.";
	name = "navigation console";
	dir = 8
	},
/turf/open/floor/plating,
/area/template_noop)
"s" = (
/turf/open/floor/plating,
/area/template_noop)
"t" = (
/obj/machinery/power/shuttle_engine/propulsion{
	dir = 8
	},
/turf/open/floor/plating,
/area/template_noop)
"v" = (
/obj/structure/frame/computer{
	dir = 8
	},
/turf/open/floor/carpet/blue,
/area/template_noop)
"z" = (
/turf/open/floor/carpet/green,
/area/template_noop)
"C" = (
/turf/open/floor/mineral/titanium,
/area/template_noop)
"I" = (
/obj/structure/showcase/machinery/tv{
	icon_state = "computer_broken";
	desc = "Uhh... you think this works? Seriously?";
	name = "scanner console"
	},
/turf/open/floor/carpet/blue,
/area/template_noop)
"K" = (
/obj/machinery/door/airlock/command/glass{
	name = "Bridge"
	},
/turf/open/floor/carpet/blue,
/area/template_noop)
"M" = (
/turf/closed/wall/mineral/titanium/nodiagonal,
/area/template_noop)
"P" = (
/obj/structure/showcase/machinery/tv{
	icon_state = "computer_broken";
	desc = "There isn't much power left to monitor...";
	name = "broken power monitor";
	dir = 1
	},
/turf/open/floor/carpet/blue,
/area/template_noop)
"R" = (
/obj/machinery/door/airlock/titanium/glass{
	name = "Survey Vessel Airlock"
	},
/turf/open/floor/plating,
/area/template_noop)
"T" = (
/obj/machinery/power/shuttle_engine/heater{
	dir = 8
	},
/obj/structure/window/reinforced/survival_pod/spawner/directional/east,
/turf/open/floor/plating,
/area/template_noop)
"V" = (
/obj/structure/sign/nanotrasen,
/turf/closed/wall/mineral/titanium/nodiagonal,
/area/template_noop)
"W" = (
/turf/open/water,
/area/template_noop)
"Y" = (
/turf/closed/wall/mineral/titanium,
/area/template_noop)

(1,1,1) = {"
a
a
a
a
a
W
W
W
W
W
W
W
a
a
a
a
a
a
a
a
a
a
a
a
a
"}
(2,1,1) = {"
a
a
a
W
W
W
W
W
W
W
W
W
W
a
a
a
a
a
a
a
a
a
a
a
a
"}
(3,1,1) = {"
a
a
a
W
W
W
W
W
W
W
W
W
W
W
W
W
W
W
a
a
a
a
a
a
a
"}
(4,1,1) = {"
a
a
a
W
W
W
W
W
W
W
W
W
W
W
W
W
W
W
W
a
a
a
a
a
a
"}
(5,1,1) = {"
a
a
W
W
W
W
W
W
W
W
W
W
W
W
W
W
W
W
W
W
W
a
a
a
a
"}
(6,1,1) = {"
a
a
W
W
W
W
W
W
W
W
W
W
W
W
W
W
W
W
W
W
W
W
a
a
a
"}
(7,1,1) = {"
a
a
W
W
W
W
W
W
W
W
W
W
W
W
W
W
W
W
W
W
W
W
W
a
a
"}
(8,1,1) = {"
a
a
W
W
W
W
W
W
W
W
M
t
t
t
t
t
M
W
W
W
W
W
W
a
a
"}
(9,1,1) = {"
a
W
W
W
W
W
W
W
W
M
M
T
T
T
T
T
M
M
W
W
W
W
W
W
a
"}
(10,1,1) = {"
a
W
W
W
W
W
W
W
Y
M
s
s
s
s
s
s
s
M
Y
W
W
W
W
W
a
"}
(11,1,1) = {"
a
a
W
W
W
W
W
W
V
s
s
M
M
z
M
M
s
s
V
W
W
W
W
W
a
"}
(12,1,1) = {"
a
a
W
W
W
W
W
W
M
M
M
M
C
z
C
M
M
M
M
W
W
W
W
W
a
"}
(13,1,1) = {"
a
a
W
W
W
W
W
W
R
s
R
z
z
z
z
z
R
s
R
W
W
W
W
a
a
"}
(14,1,1) = {"
a
a
a
W
W
W
W
W
M
M
M
M
C
z
C
M
M
M
M
W
W
W
W
a
a
"}
(15,1,1) = {"
a
a
a
W
W
W
W
W
Y
M
C
C
C
z
C
C
C
M
Y
W
W
W
a
a
a
"}
(16,1,1) = {"
a
a
a
a
W
W
W
W
W
m
C
C
C
z
C
C
C
m
W
W
W
W
a
a
a
"}
(17,1,1) = {"
a
a
a
a
W
W
W
W
W
Y
M
M
M
K
M
M
M
Y
W
W
W
W
a
a
a
"}
(18,1,1) = {"
a
a
a
a
a
W
W
W
W
W
M
I
l
l
s
P
M
W
W
W
W
W
a
a
a
"}
(19,1,1) = {"
a
a
a
a
a
W
W
W
W
W
M
M
v
s
p
M
M
W
W
W
W
W
a
a
a
"}
(20,1,1) = {"
a
a
a
a
a
W
W
W
W
W
W
Y
m
s
m
Y
W
W
W
W
W
a
a
a
a
"}
(21,1,1) = {"
a
a
a
a
a
W
W
W
W
W
W
W
W
W
W
W
W
W
W
W
W
a
a
a
a
"}
(22,1,1) = {"
a
a
a
a
a
W
W
W
W
W
W
W
W
W
W
W
W
W
W
W
a
a
a
a
a
"}
(23,1,1) = {"
a
a
a
a
a
a
a
a
W
W
W
W
W
W
a
a
a
a
a
a
a
a
a
a
a
"}
(24,1,1) = {"
a
a
a
a
a
a
a
a
a
a
a
a
a
a
a
a
a
a
a
a
a
a
a
a
a
"}
(25,1,1) = {"
a
a
a
a
a
a
a
a
a
a
a
a
a
a
a
a
a
a
a
a
a
a
a
a
a
"}
